1111111
1P0C001
1110101
10C00E1
1111111




