1111111111
1001111111
100000P001
1001100001
1101110111
1000001101
100CE00001
1111111111
