1111111111
1000000001
1001100111
1000100001
10011C0001
1001100001
100000P001
1000001101
1000E00001
1111111111
