1111111
1P00001
1110101
1111111
10C00E1
1111111