11111
1P0C1
11111
100E1
11111
