11111
1P001
11111
10C01
100E1
11111
